NO ./textures/north2.png
SO ./textures/south2.png
WE ./textures/west2.png
EA ./textures/east2.png

F 220,100,0
C 225,30,0

             11111111111111111111
    11111111110000000000000000001
    1000000000000000000000000001
	11111111110000000000000000001
             10000000000000000001
11111111111110000000000000000001
10000000000000000000000000000001
10000000000000000000000000000001
10000000000000000000000000000001
10000000000000000000N00000000001
10000000000000000000000000000001
11111111111111111111111111111111